{
    "1685": 10,
    "1683": 11,
    "1678": 12,
    "1672": 13,
    "1662": 14,
    "1621": 15
}